.......................................................................................................................
...P...................................................................................................................
.......................................................................................................................
.......................................................................................................................
.......................................................................................................................
.......................................................................................................................
..................@....................................................................................................
.......................................................................................................................
.......................................................................................................................
.......................................................................................................................
.......................................................................................................................
#######################################################################################################################
#######################################################################################################################
#######################################################################################################################
#######################################################################################################################